11
...........
######.###.
######.###.
##.....###.
##.#######.
...#######.
.#########.
.#########G
..S########
###########
.....######