10
.........G
.#########
.#########
.#...#####
.#.#######
...#######
.#########
.#########
..S#######
.#########
